111111111111111111
100010000000000001
1011111100000000Q1
1000P00000111000011111111
100000000010000001
100000000010000001
111111111111111111