1111111111111111111111
1E000C000011E000C00001
1011111100110111111001
1000P0000011000P000001
10000C0000110000C00001
1111111111111111111111