11111111111111111
100010000000000001
1011111100000000Q1
1000P0000011100001
100000000010000001
100000000010000001
1111111111111111111