1111111111111111111111111111111111111111111111111
1P00000000000000000000000000000000000000000000001
1000000000000000000000000000000000000000000000001
1000000000000000000000000000000000000000000000001
1000000000000000000000000000000000000000000000001
10000C00C000MMMM000C000000M0000000CC0000000000001
10000C00C000M000000C000000M000000C00C000000000001
10000CCCC000MMM0000C000000M000000C00C000000000001
10000C00C000M000000C000000M000000C00C000000000001
10000C00C000MMMM000CCCC000MMMM0000CC0000000000001
1000000000000000000000000000000000000000000000001
1000000000000000000000000000000000000000000000001
1000000000000000000000000000000000000000000000001
1000000000000000000000000000000000000000000000001
1000000000000000000000000000000000000000000000001
1000000000000000000000000000000000000000000000001
1000000000000000000000000000000000000000000000001
1000000000000000000000000000000000000000000000001
10000000000000000000000000000000000000000000E0001
1000000000000000000000000000000000000000000000001
1111111111111111111111111111111111111111111111111
