111111111111111111111111111
1P0000000000000000000000001
100000000MMM000000MMMMMMMM1
1000000MCM000000MCM0000MCM1
10000CMC0CMC000000000MCM001
100C1C00CMC0000000C1C000001
1C1C1C1C1C1C000C1C000000001
1000001C100001C100000000001
1000011100011111111EMM00001
100000000000000000000000001
111111111111111111111111111