11111111111
1E000100C01
11111111001
1000P100001
10000100001
11111111111