1111111111111
10000010000E1
10C00P1000001
1111111111111