111111111111111
100           1
1    E        1
1C  P         1
111111111111111