111111111111111111
1C001C000000C00001
10111111000000C0E1
1000P0000011100001
10000C000010C00001
10C000000010000001
100000000010000001
100000000010000001
100001000010000001
100001000010111001
10000C000010000001
1000000000100C0001
100000000000000001
100000011100000001
10C000000000000001
10000000C000000001
100000000000000C01
111111111111111111