11111111111
1E000C00001
10111111001
1000P000001
10000C00001
11111111111